#GENERAL

\leftarrow => ←
\rightarrow => →
\leftrightarrow => ↔
\Leftarrow => ⇐
\Rightarrow => ⇒
\Leftrightarrow => ⇔

#SPEEDCRUNCH


#CAS

// Units


bunch \{text, mathrm}[] => _[]
{
    s   => s
    m   => m
    g   => gm
    A   => A
    K   => K°
    mol => mol
    cd  => cd

    l   => l
    h   => hr
    sr  => sr
    Hz  => Hz
    Pa  => Pa
    N   => N
    J   => J
    W   => W
    C   => coul
    V   => V
    F   => F
    Ω   => Ω
    Wb  => Wb
    T   => T
    H   => henry
    lm  => lm
    lx  => lx
    Bq  => Bq
    Gy  => Gy
    Sv  => Sv
    rad =>
}

#CUSTOM ...